10
# # # # # # #
# . . . . . #
# . # # # . #
# . # > . . #
# . # # # . #
# . . . . . #
# # # # # # #